sssssssssssss
sA..........s
s.....U.....s
s...........s
s...........s
s...........s
s.....E.....s
s...........s
sssssssssssss